碍	礙
奥	奧
抜	拔
覇	霸
拝	拜
阪	坂
幇	幫
宝	寶
綳	繃
偪	逼
変	變
辨	辯
辺	邊
彬	斌
併	並
氷	冰
剥	剝
鉢	缽
歩	步
采	採
残	殘
蚕	蠶
惨	慘
参	參
飡	餐
厠	廁
挿	插
禅	禪
蝉	蟬
産	產
巣	巢
徹	澈
儭	襯
乗	乘
称	稱
遅	遲
勅	敕
歯	齒
喫	吃
虫	蟲
沖	衝
畴	疇
筹	籌
紬	綢
丑	醜
厨	廚
触	觸
齣	出
床	牀
窓	窗
磁	瓷
辞	辭
従	從
聡	聰
粋	粹
脃	脆
膵	脺
帯	帶
弾	彈
惮	憚
胆	膽
単	單
担	擔
档	檔
党	黨
当	當
盗	盜
稲	稻
𢭏	搗
祷	禱
徳	德
灯	燈
蔕	蒂
逓	遞
淀	澱
点	點
瘨	癲
顚	顛
弔	吊
彫	雕
畳	疊
斗	鬥
独	獨
読	讀
妬	妒
断	斷
兌	兑
対	對
吨	噸
惇	敦
堕	墮
朶	朵
躱	躲
鵞	鵝
悪	惡
鰐	鱷
児	兒
発	發
汎	泛
旛	幡
倣	仿
廃	廢
丰	豐
峰	峯
複	復
摡	溉
干	幹
尲	尷
杠	槓
箇	個
亘	亙
巩	鞏
彀	夠
鉤	鈎
雇	僱
穀	谷
舘	館
関	關
観	觀
桧	檜
亀	龜
帰	歸
国	國
菓	果
扞	捍
号	號
黒	黑
恒	恆
横	橫
后	後
冱	滬
戸	户
划	劃
画	畫
嘩	譁
嘩	譁
懐	懷
壊	壞
坏	壞
鐶	鍰
歓	歡
黄	黃
廻	回
会	會
彙	匯
恵	惠
絵	繪
穫	獲
伙	夥
耤	藉
剤	劑
済	濟
継	繼
撃	擊
姫	姬
机	機
鶏	雞
价	價
剣	劍
践	踐
倹	儉
堿	鹼
検	檢
奨	獎
蒋	蔣
将	將
畺	疆
脚	腳
届	屆
掲	揭
晋	晉
尽	盡
衿	襟
凈	淨
径	徑
静	靜
経	經
茎	莖
厩	廄
旧	舊
玖	九
韮	韭
惧	懼
据	據
挙	舉
捲	卷
絶	絕
覚	覺
忼	慷
壳	殼
渇	渴
齦	啃
宼	寇
袴	褲
寛	寬
鉱	礦
媿	愧
餽	饋
拡	擴
腊	臘
来	來
頼	賴
擥	攬
覧	覽
労	勞
楽	樂
涙	淚
塁	壘
厘	釐
励	勵
歴	歷
歴	厲
栗	慄
隷	隸
礼	禮
裡	裏
里	裏
怜	憐
鎌	鐮
恋	戀
両	兩
猟	獵
燐	磷
隣	鄰
凛	凜
霊	靈
齢	齡
瑠	琉
楼	樓
炉	爐
芦	蘆
録	錄
禄	祿
緑	綠
屡	屢
乱	亂
崙	侖
売	賣
麦	麥
蛮	蠻
満	滿
猫	貓
么	麼
没	沒
苺	莓
毎	每
弥	彌
祢	禰
愍	憫
么	麼
黙	默
万	萬
拏	拿
嚢	囊
閙	鬧
悩	惱
脳	腦
内	內
伱	你
鮎	鯰
醸	釀
孼	孽
蘖	櫱
苧	薴
呕	嘔
欧	歐
殴	毆
砲	炮
抛	拋
掽	碰
毘	毗
辟	闢
疋	匹
凭	憑
苹	蘋
朴	樸
埼	崎
斉	齊
碁	棋
気	氣
凄	悽
栖	棲
潜	潛
銭	錢
浅	淺
墻	牆
陗	峭
窃	竊
捦	擒
寝	寢
区	區
麹	曲
躯	軀
駆	驅
権	權
勧	勸
圏	圈
却	卻
群	羣
譲	讓
壌	壤
遶	繞
栄	榮
叡	睿
洒	灑
騒	騷
渋	澀
厦	廈
刹	剎
晒	曬
焼	燒
摂	攝
渉	涉
渗	滲
縄	繩
剰	剩
声	聲
実	實
釈	釋
湿	濕
虱	蝨
獣	獸
寿	壽
痩	瘦
収	收
数	數
竪	豎
属	屬
枢	樞
疎	疏
双	雙
四	肆
嵩	崧
薮	藪
遡	溯
粛	肅
甦	穌
随	隨
歳	歲
砕	碎
髄	髓
踏	蹋
他	她
他	它
歎	嘆
涛	濤
籐	藤
嚔	嚏
体	體
塡	填
条	條
銕	鐵
庁	廳
聴	聽
偸	偷
図	圖
兎	兔
団	團
頽	頹
呑	吞
楕	橢
托	託
拕	拖
袜	襪
卍	萬
晩	晚
椀	碗
弯	彎
湾	灣
衛	衞
穏	穩
臥	卧
呉	吳
汚	污
係	系
繫	系
渓	溪
犠	犧
侠	俠
峡	峽
狭	狹
咸	鹹
絃	弦
閑	閒
県	縣
献	獻
陥	陷
顕	顯
険	險
繊	纖
郷	鄉
効	效
咲	笑
暁	曉
挟	挾
携	攜
脇	脅
写	寫
衅	釁
倖	幸
凶	兇
胸	匈
汹	洶
銹	鏽
叙	敍
続	續
吁	籲
嘘	噓
虚	虛
学	學
勲	勳
亜	亞
唖	啞
圧	壓
厳	嚴
塩	鹽
岩	巖
閆	閻
顔	顏
彦	彥
艶	豔
贋	贗
鴈	雁
験	驗
様	樣
痒	癢
揺	搖
瑶	瑤
肴	餚
謡	謠
遥	遙
曜	耀
燿	耀
薬	藥
叶	葉
訳	譯
医	醫
婬	淫
隠	隱
営	營
蛍	蠅
応	應
桜	櫻
踊	踴
祐	佑
于	於
余	餘
娯	娛
喩	喻
育	毓
誉	譽
預	豫
郁	鬱
与	與
俣	俁
縁	緣
岳	嶽
云	雲
蘊	藴
醞	醖
雑	雜
賛	贊
攅	攢
臓	髒
臓	髒
喿	噪
竈	灶
皁	皂
択	擇
増	增
砦	寨
斎	齋
占	佔
戦	戰
帳	賬
櫂	棹
摺	折
眞	真
鍼	針
証	證
抍	拯
争	爭
征	徵
値	值
製	制
誌	志
滞	滯
緻	致
衆	眾
塚	冢
鐘	鍾
呪	咒
昼	晝
箒	帚
週	周
註	注
筑	築
鋳	鑄
嘱	囑
瞩	矚
猪	豬
転	轉
専	專
塼	磚
壮	壯
状	狀
粧	妝
庄	莊
装	裝
准	準
眦	眥
姉	姊
縦	縱
総	總
踪	蹤
酔	醉